.^^^^^^^^^........................................................
....^.............................................................
................................^^.................^..............
...............................^^^^.................^^............
...............................^^^^..................^............
..............................^^^^^^^.................^...........
............................^^^^^^^^^^.^..........................
.........^.............^^..^^^^^^^^^^^^^^^............^^..........
..........^..........^^^^^^^.^........^^^^............^...........
.....^...^^..........^..................^^^.......................
..........^.............................^^^^......^.....~.........
..........^^.........^....................^^^^.........~~.........
..........^^.........^^^^^^^..............^^^........~~~~~........
............^.........^^^^^^..............^^^.........~~~.........
.......................^^^^^^^............^^...........~..........
.......................^^^^^^^^^...^......^.......................
........................^^^^^^^^^^^.^^^..^^...........~...........
.........................^^^^^^^^^^^^^^^^^^.......~~~~~~~.........
...~......................^^^^^^^^^..^^^^........~~~~~~~~~........
...~~......................^^^^^^^....^.........~~~~~~~~~~........
..~~~~~~....................^^^^.................~~~~~~~~.........
...~~~~.....................^^^^^.................~..~~~..........
....~~........................^^^...............~.................
............~~~~..~~..........^.........................^.........
..........~~~~~~~~~~~~...^^...........................^^^.........
........~~~~^^^^^^^^^^^^^^^^^........................^............
