.^^^^^^^^^.....................................................
....^..........................................................
................................^^.................^...........
...............................^^^^.................^^.........
...............................^^^^..................^.........
..............................^^^^^^^.................^........
............................^^^^^^^^^^.^.......................
.........^.............^^..^^^^^^^^^^^^^^^............^^.......
..........^..........^^^^^^^.^........^^^^............^........
.....^...^^..........^..................^^^....................
..........^.............................^^^^......^.....~......
..........^^.........^....................^^^^.........~~......
..........^^.........^^^^^^^..............^^^........~~~~~.....
............^.........^^^^^^..............^^^.........~~~......
.......................^^^^^^^............^^...........~.......
.......................^^^^^^^^^...^......^....................
........................^^^^^^^^^^^.^^^..^^...........~........
.........................^^^^^^^^^^^^^^^^^^.......~~~~~~~......
...~......................^^^^^^^^^..^^^^........~~~~~~~~~.....
...~~......................^^^^^^^....^.........~~~~~~~~~~.....
..~~~~~~....................^^^^.................~~~~~~~~......
...~~~~.....................^^^^^.................~..~~~.......
....~~........................^^^...............~..............
............~~~~..~~..........^.........................^......
..........~~~~~~~~~~~~...^^...........................^^^......
........~~~~^^^^^^^^^^^^^^^^^........................^.........